{
	"map":[
		[1,1,1,1,1,1,1,1,1,1,1,1,1,1,1,1,1,1,1,1,1,1],
		[1,0,0,0,0,0,0,0,0,0,0,0,0,0,0,0,0,0,0,0,0,1],
		[1,0,0,0,0,0,0,0,0,0,0,0,0,0,0,0,0,0,0,0,0,1],
		[1,0,0,0,0,0,0,0,0,0,0,0,0,0,0,0,0,0,0,0,0,1],
		[1,0,0,0,0,0,0,0,0,0,0,0,0,0,0,0,0,0,0,0,0,1],
		[1,0,0,0,0,0,0,0,0,0,0,0,0,0,0,0,0,0,0,0,0,1],
		[1,0,0,0,0,0,0,0,0,0,0,0,0,0,0,0,0,0,0,0,0,1],
		[1,1,1,1,1,1,1,1,1,1,1,1,1,1,1,1,1,1,1,1,1,1]
	],
	"tileTypes": {
		"0": {"type": "GrassTile", "convertable": true },
		"1": {"type": "TowerTile", "wall": true }
	},
	"start": { "x": 1, "y": 3 },
	"goal": { "x": 10, "y": 3 }
}